##########
#   S#F   
#    #    
#    #    
#  ###### 
#    #    
#    #    
#    #    
#         
#         
#         
