##########
#S       #
#        #
#        #
#        #
#        #
#       F#
##########
