##########
#S       #
#        #
#####    #
#        #
#        #
#F       #
##########
